Aceite de maíz	Aceites y materias grasas
Aceite de oliva	Aceites y materias grasas
Aceite de soja	Aceites y materias grasas
Acelga	Setas y verduras
Agridulce	Salsas
Aguacate	Frutas
Ajedrea	Especias
Ajo	Condimentos
Ajo en polvo	Especias
Albahaca	Especias
Albaricoque	Frutas
Alcachofa	Setas y verduras
Ali oli	Salsas
Almeja	Marisco
Almendra	Especias
Alubias	Legumbres
Amapola	Especias
Anacardo	Frutos secos
Ancas de rana	Otros
Anchoa	Pescado
Angélica	Especias
Anís estrellado	Especias
Anís verde	Especias
Apio	Especias
Apio en polvo	Especias
Árbol del curry	Especias
Arborio	Arroz
Atún	Pescado
Avellana	Frutos secos
Avestruz	Carnes
Azafrán	Especias
Azucar	Condimento
Bacalao	Pescado
Barbacoa	Salsas
Basmati	Arroz
Batata	Setas y verduras
Berenjena	Setas y verduras
Berro	Setas y verduras
Bison	Carnes
Boloñesa	Salsas
Bomba	Arroz
Bonito	Pescado
Boquerón	Pescado
Brava	Salsas
Brecol	Setas y verduras
Brie	Quesos
Brócoli	Setas y verduras
Buey	Carnes
Butifarra	Embutidos
Caballa	Pescado
Caballo	Carnes
Cabeza de jabali	Embutidos
Cabra	Carnes
Cabrales	Quesos
Cacahuete frito	Frutos secos
Cacao	Dulce
Calabacín	Setas y verduras
Calabaza	Setas y verduras
Calamar	Marisco
Camarón	Marisco
Camembert	Quesos
Canela	Especias
capones	Carnes
Caracoles	Otros
Caramelo	Dulce
Carbonara	Salsas
Cardamomo	Especias
Cardo	Setas y verduras
Castañas	Frutos secos
Cebolla	Setas y verduras
Cebolla frita	Condimento
Cebolla seca	Especias
Cebolleta	Setas y verduras
Cerdo	Carnes
Cereales	Otros
Cereza	Frutas
Cesar	Salsas
Chedar	Quesos
Chicharro	Pescado
Chili	Condimentos
Chocolate	Dulce
Chocolate blanco	Dulce
Chocolate negro	Dulces
Chorizo	Embutidos
Ciervo	Carnes
Cigala	Marisco
Cilantro	Especias
Ciruela	Frutas
Clavo de olor	Especias
Coco	Frutas
Coles	Setas y verduras
Coles de Bruselas	Setas y verduras
Coliflor	Setas y verduras
Comino	Especias
Comino negro	Especias
Conejo	Carnes
Cordero	Carnes
Corvina	Pescado
Cuatro quesos	Salsas
Cúrcuma	Especias
Curry	Especias
Dorada	Pescado
Edam	Quesos
Emmental	Quesos
Endivia	Setas y verduras
Enebro	Especias
Eneldo	Especias
Escarola	Setas y verduras
Espárrago	Setas y verduras
Espinaca	Setas y verduras
Espliego	Especias
Estragón	Especias
Faisanes	Carnes
Frambuesa	Frutas
Fresa	Frutas
Fruta del bosque	Frutas
Fruta seca	Frutas
Frutos secos	Frutas
Fuet	Embutidos
Galanga	Especias
Gallinas	Carnes
Gamba	Marisco
Garbanzos	Legumbres
Gloucester	Salsas
Gnocchi	Pasta
Gorgonzola	Quesos
Gouda	Quesos
Grana-Padanno	Quesos
Granada	Frutas
Granos de paraíso	Especias
Gruyere	Quesos
Guacamole	Frutas
Guindilla	Especias
Guisante	Setas y verduras
Haba tonka	Especias
Habas	Setas y verduras
Harinas	Otros
Helado	Productos lácteos
Higos	Frutas
Higos secos	Frutos secos
Hinojo	Especias
Hongos	Setas y verduras
Huevos	Otros
Jabalí	Carnes
Jamon serrano	Embutidos
Jamon York	Embutidos
Jengibre	Especias
Judías	Setas y verduras
Kebab	Carne
Ketchup	Salsas
Kiwi	Frutas
Langostino	Marisco
Largo	Arroz
Laurel	Especias
Lavanda	Especias
Leche	Productos lácteos
Lechugas	Setas y verduras
Lenguado	Pescado
Lentejas	Legumbres
Levístico	Especias
Liebre	Carnes
Limón	Frutas
Lonchas de pavo	Embutidos
Longaniza	Embutidos
Lubina	Pescado
Macarrones	Pasta
Macis	Especias
Maíz	Setas y verduras
Manchego	Quesos
Mandarina	Frutas
Mango	Frutas
Manzanas	Frutas
Mascarpone	Quesos
Mayonesa	Salsas
Mejillón	Marisco
Mejorana	Especias
Melocotones	Frutas
Melón	Frutas
Membrillo	Frutas
Menta	Especias
Menta piperita	Especias
Menta poleo	Especias
Merluza	Pescado
Mero	Pescado
Miel	Condimentos
Mojo picón	Salsas
Morcilla	Embutidos
Mortadela	Embutidos
Mostaza	Especias
Naranja	Frutas
Nata o crema de lech	Productos lácteos
Nectarina	Frutas
Nigella	Especias
Nueces	Frutos secos
Nuez moscada	Especias
Ocas	Carnes
Olivas negras	Aceitunas
Olivas sabor anchoa	Aceitunas
Olivas verdes	Aceitunas
Oporto	Salsas
Orégano	Especias
Oso	Carnes
Ostra	Marisco
Ovejas	Carnes
Palmito	Setas y verduras
Paloma	Carnes
Palometa	Pescado
Panes	Otros
Papaya	Frutas
Parmesano	Quesos
Pasas	Frutos secos
Patata	Setas y verduras
Patos	Carnes
Pavos	Carnes
Pejerrey	Pescado
Pepinillos	Aceitunas
Pepino	Setas y verduras
Peras	Frutas
Percebe	Marisco
Perdiz	Carnes
Perejil	Especias
Perifollo	Especias
Philadelphia	Quesos
Pimenta dioica	Especias
Pimentón	Especias
Pimienta	Especias
Pimienta de Sichuan	Especias
Pimienta larga	Especias
Pimiento	Setas y verduras
Piña	Frutas
Piñones	Frutos secos
Pistacho	Frutos secos
Plátano	Frutas
Pollo	Carnes
Pomelo	Frutas
Provolone	Quesos
Puerro	Setas y verduras
Pulpo	Marisco
Queso	Productos lácteos
Queso azul	Quesos
Queso de tetilla	Quesos
Raíces	Especias
Raíces y tubérculos	Setas y verduras
Rape	Pescado
Ravioli	Pasta
Regaliz	Especias
Remolacha	Setas y verduras
Resinas	Especias
Risotto	Arroz
Rodaballo	Pescado
Romero	Especias
Roquefort	Quesos
Rosa	Especias
Rúcula	Especias
Ruda	Especias
Sal	Condimento
Salchichas	Carne
Salchichas Frankfurt	Carne
Salchichon	Embutidos
Salmón	Pescado
Salvia	Especias
Sandía	Frutas
Sardina	Pescado
Semillas de calabaza	Frutos secos
Semillas de girasol	Frutos secos
Semillas de granada	Especias
Sepia	Marisco
Sésamo	Especias
Setas	Setas y verduras
Soja	Legumbres
Spaghetti	Pasta
Sushi	Pescado
Tallarines	Pasta
Tamarindo	Especias
Ternera	Carnes
Tomate	Setas y verduras
Tomillo	Especias
Tortellini	Pasta
Trucha	Pescado
Uvas	Frutas
Vaca	Carnes
Vainilla	Especias
Verde	Salsas
Vieira	Marisco
Vinagre	Condimento
Vinagre de Modena	Condimento
Wasabi	Especias
Yogur	Productos lácteos
Zanahoria	Setas y verduras
Zumaque	Especias
